Vérification des emails générés :
Nom complet  ->  Email généré
-----------------------------------
Alexia BORDERIE           -> alexia@theoma.fr
Alicia Bejar              -> alicia@theoma.fr
Alix Sonam                -> alix@theoma.fr
Anais DE JESUS            -> anais@theoma.fr
Anne-Cecile Joseph        -> anne-cecile@theoma.fr
Anne-Marie Mendy          -> anne-marie@theoma.fr
Arnaud Guichaoua          -> arnaud@theoma.fr
Bertille  COURT           -> bertille@theoma.fr
Caroline Brillet          -> caroline@theoma.fr
Charlotte MOULINIER       -> charlotte@theoma.fr
Christ-Leroy Tsika        -> christ-leroy@theoma.fr
Coumba Sylla              -> coumba@theoma.fr
Célia Aouche              -> celia@theoma.fr
Fanny VIROLLET            -> fanny@theoma.fr
Hugo Grellier             -> hugo@theoma.fr
Kassandra  BRUNEAU        -> kassandra@theoma.fr
Kelly Gounelle            -> kelly@theoma.fr
Laura BARUK               -> laura@theoma.fr
Leïla Guendouz            -> leila@theoma.fr
Lise Massei               -> lise@theoma.fr
Margaux Castro            -> margaux@theoma.fr
Marine CHAILLON           -> marine@theoma.fr
Marion  VIROLLE           -> marion@theoma.fr
Mélanie Voymant           -> melanie@theoma.fr
Nasteho Said              -> nasteho@theoma.fr
Natalie POISSON           -> natalie@theoma.fr
Randy Biswese             -> randy@theoma.fr
Regis GODEFROY            -> regis@theoma.fr
Romain GIPOULOU           -> romain@theoma.fr
Sanadati RIDHOI           -> sanadati@theoma.fr
Sandra EMERY              -> sandra@theoma.fr
Sarah Rhallab             -> sarah@theoma.fr
Stéphanie JOLY            -> stephanie@theoma.fr
